Messi – Antonela Rocuzzo

Cristiano Ronaldo – Georgina

Beyoncé – Jay-Z

Blake Lively – Ryan Reynolds

Shakira – Piqué

Jennifer Lopez – Ben Affleck

Zendaya – Tom Holland

Victoria Beckham – David Beckham

Miley Cyrus – Liam Hemsworth 

Sofia Vergara – Joe Manganiello

Penélope Cruz – Javier Bardem

LeBron James – Savannah

Will Smith – Jada Pinkett Smith

Elsa Pataky – Chris Hemsworth

Marina – Jesús

Fani Carbajo – Christofer

Alba – Gerard

Mayeli - Alvaro

Juanpi - Sandra

Gilbert - Claudia

Rodri - Helena

Dario - Almudena

Sanju - Amaia

Maka - Eider

Jaure - Yune

Hugo - Maite

Anaitz - Ainhize

Elorri - Naia

Ainhize Picado - Dani

Almike - Kepa

Andrea - Dani 2

Azu - La de mungi

Jimen - Aroa

Aitana - Txutxi

Biotza - El novio

Soto - Ane

Irati Lasa - Urkidi

Zaira - Martin

More - Naia

Laiu - June

Maria Garai - Markelmu

Aroa - Bustin

Muru - Naia

Maria - Lazaro

Nagore - Lazaro

Aiara - Ioritz









